also remove image=usuń również obraz
Apply=Zastosuj
Are you sure=Czy jesteś pewien?
Cancel=Anuluj
checking=sprawdzanie
Completely REMOVE=USUŃ całkowicie
Console=Konsola
day=dzień
days=dni
disk image and definition=definicja i obraz dysku
Disks=Dysk
Donate=
Done=Gotowe
Edit=Edytuj
Execution error=Błąd wykonania
Force Stop=Wymuś Zatrzymanie
Hibernate=Hibernuj
Log for=Zaloguj na:
log=Zaloguj
Logs=Logi
More Info=Więcej informacji
No=Nie
OK=OK
Ok=Ok
Pause=Pauza
Proceed=Kontynuuj
Project Page=Strona Projektu
Read Me First=
Remove container=Usuń kontener
Remove definition=Usuń definicje
Remove image=Usuń obraz
Remove VM=Usuń MW
Remove=Usuń
Restart=Uruchom ponownie
Resume=Wznów
Start=Uruchom
Stop=Zatrzymaj
Support=Wsparcie
Update container=Zaktualizuj kontener
Update=Aktualizacja
Updating all Containers=Aktualizowanie wszystkich Kontenerów
Updating the container=Aktualizacja kontenera
VNC Remote=Zdalne VNC
WebUI=WebUI
Yes, delete it=Tak, usuń to!
Yes, update it=Tak, uaktualnij to!
Yes=Tak

; footer messages
Array Starting=Uruchamianie macierzy
Array Stopping=Zatrzymywanie macierzy
Mounting disks=Montowanie dysków
Spinning up all drives=Rozkręcanie wszystkich dysków
Starting services=Uruchamianie usług
Stopping services=Zatrzymywanie usług
Unmounting disks=Odmontowywanie dysków
Autostart disabled=Autouruchamianie wyłączone
Missing encryption key=Brak klucza szyfrującego
Opening encrypted volumes=Otwieranie zaszyfrowanych woluminów

; docker variables
Container Path=Ścieżka kontonera
Container Port=Port kontenera
Container Variable=Zmienne kontenera
Container Label=Nazwa kontenera
Container Device=Urządzenia kontenera

; Note: February 8, 2022 - 2 missing translations
