A format is NEVER part of a data recovery or disk rebuild process and if done in such circumstances will normally lead to loss of all data on the disks being formatted=Formatowanie **NIGDY** nie jest elementem procedury odzyskiwania danych ani odbudowywania dysku. Jeśli dysk zostanie sformatowany w tych przypadkach, najczęściej doprowadzi to do utraty wszystkich danych na wszystkich formatowanych dyskach.
Aborted=Anulowano
Action=Akcja
Add Pool=Dodaj pulę
Add=Dodaj
All existing data on this device will be OVERWRITTEN when array is Started=Wszystkie dane istniejące obecnie na tym urządzeniu zostaną NADPISANE gdy macierz zostanie uruchomiona
Array Devices=Urządzenia w macierzy
Array of %s devices=Macierz %s urządzeń
Array Operation=Operacje na macierzy
Attribute Name=Nazwa atrybutu
Attributes not available=
Attributes=Atrybuty
auto=auto
Autotrim=
Balance Status=Status balansowania
Balance=Balansowanie
Blacklisted=Czarna lista
Boot Device=Urządzenie rozruchowe
Boot system in UEFI mode=Rozruch systemu w trybie UEFI
btrfs balance status=status balansowania btrfs
btrfs check status=status sprawdzania btrfs
btrfs filesystem df=df systemu plików btrfs
BTRFS operation is running=Operacja BTRFS jest uruchomiona
btrfs scrub status=Status sprzątania btrfs
Canceled=Anulowano
Cannot contact key-server Please check your=Nie można połączyć się z serwerem licencji. Proszę sprawdź
Capabilities not available=
Capabilities=Możliwości
Check Filesystem Status=Sprawdź status systemu plików
Clear Stats=Wyczyść statystyki
Clearing in progress=Trwa czyszczenie
Click on FLASH above this message=Kliknij **FLASH** powyżej tej wiadomości
Click to spin down device=Kliknij by przełączyć w tryb gotowości
Click to spin up device=Kliknij by wybudzić z trygu gotowości
Comments=Komentarze
complete=ukończone
Completed without error=Ukończone bez błędów
completed=zakończone
Compression=
Configuration valid=Konfiguracja prawidłowa
Convert to raid0 mode=Przekonwertuj na raid0
Convert to raid1 mode=Przekonwertuj na raid1
Convert to raid10 mode=Przekonwertuj na raid10
Convert to raid1c3 mode=Konwertuj do raid1c3
Convert to raid1c4 mode=Konwertuj do raid1c4
Convert to raid5 mode see help=Przekonwertuj na raid5 *zobacz pomoc
Convert to raid6 mode see help=Przekonwertuj na raid6 *zobacz pomoc
Convert to single mode=Przekonwertuj na tryb pojedynczy
Copying=Kopiowanie
corrected=poprawione
Create an empty file system on the disks shown as Unmountable discarding all data currently on the disks and update parity to reflect this=Utwórz pusty system plików na dysku opisanym jako **Niemontowalny**, usuwając jednocześnie wszystkie dane na wszystkich dyskach, oraz zaktualizuj dane parzystości by odzwierciedlały te zmiany
creating Flash backup zip file this may take several minutes=tworzenie kopii zapasowej dysku flash w postaci pliku zip (może to potrwać kilka minut)
Creating Flash backup=Tworzenie kopii zapasowej pamięci flash
Creation error=Błąd tworzenia
Critical disk temperature threshold=Próg krytycznej temperatury dysku
Critical disk utilization threshold=Próg krytycznego wykorzystania dysku
Current operation %s on %s=Obecna operacja %s na **%s**
Current position=Obecna pozycja
Custom attributes use comma to separate numbers=Własne atrybuty (użyj przecinka dla oddzielenia cyfr)
Data-Rebuild in progress=Postęp odbudowy danych
Date of purchase=Data zakupu
Date=Data
Delete Pool=Usuń pulę
detected=wykryty
Device encrypted and unlocked=Urządzenie zaszyfrowane i odblokowane
Device encrypted=Urządzenie zaszyfrowane
Device is part of a pool=Urządzenie jest częścią puli
Device locked unknown error=Urządzenie zablokowane: nieznany błąd
Device locked wrong encryption key=Urządzenie zablokowane: błędny klucz szyfrujący
Device to be encrypted=Urządzenie zostanie zaszyfrowane
Disable Spin down delay to run a SMART extended self-test=Disable **Spin down delay** to run a SMART extended self-test
Disk in parity slot is not biggest=Dysk ustawiony dla przechowywania parzystości, nie jest największym z dysków
Disk Log Information=Informacje z dziennika dysku
Disk-Clear in progress=Czyszczenie dysku w toku
Do not use reserved names=Nie używaj nazw zarezerwowanych
Do not use user share names=Nie używaj nazw udziałów
Download SMART report=Pobierz raport SMART
Dual parity valid requires ALL disks in their original slots=Sprawdzenie *Podwójnej parzystości* wymaga **WSZYSTKICH** dysków zainstalowanych na swoich oryginalnych pozycjach.
Elapsed time=Upłynęło
Enable user share assignment=Włącz przypisywanie udziału użytkownika
encrypted=zaszyfrowany
Encryption input=Wejście szyfrowania
Encryption status=Status szyfrowania
enter disk index and device name as applicable to your controller=wprowadź indeks dysku i nazwę urządzenia zgodne z kontrolerem
Enter new key=Wprowadź nowy klucz
Erase Device Content=Usuń zawartość urządzenia
Errors occurred - Check SMART report=Wystąpiły błędy - sprawdź raport SMART
Estimated finish=Przewidywane czas zakończenia
Estimated speed=Przybliżona prędkość
Existing content is permanently lost=Istniejąca zawartość zostaje trwale usunięta
Failed=Nie powiodło się
Feature=Funkcja
File system status=Status systemu plików
File system type=Typ systemu plików
Finding %s error=Znaleziono: **%s** błąd
Finding %s errors=Znaleziono: **%s** błędów
Flag=Flaga
Flash backup=Kopia zapasowa pamięci flash
Flash device is set as public share=Napęd flash zostaje publicznie udostępniony
Flash Device Settings=Ustawienia urządzenia flash
Format Unmountable disks=Formatuj niemontowalne dyski
Formatting=Formatowanie
formatting=formatowanie
Free=Wolne
FS=FS
Global Configuration=Globalna konfiguracja
Hide=Ukryj
Identification=Identyfikacja
Identity is not available=
Identity=Tożsamość
if checked, Start array but do not mount disks=jeśli zaznaczone, uruchom macierz, ale nie montuj dysków
If this is a new array, move the largest disk into the parity slot=If this is a new array, move the largest disk into the *parity* slot
If you are adding a new disk or replacing a disabled disk, try Parity-Swap=Jeśli dodajesz nowy dysk lub wymieniasz niesprawny dysk, spróbuj wykonać procedurę zamiany parzystości
Incorrect confirmation=
Information=Informacja
Insufficient free disk space available=Niewystarczająca wolna przestrzeń na dysku
Interrupted=Przerwane
Invalid configuration=Nieprawidłowa konfiguracja
invalid device=nieprawidłowe urządzenie
invalid devices=nieprawidłowe urządzenia
Invalid expansion=Nieprawidłowe rozszerzenie
Invalid pool name=Nieprawidłowa nazwa puli
Invalid, missing or expired=Nieprawidłowy, utracony lub wygaśnięty
is only available when array is Started in Maintenance mode=jest dostępne tylko gdy macierz jest uruchomiona w trybie **konserwacji**
is only available when array is Started=jest dostępne tylko gdy macierz jest uruchomiona
Keyfile=Plik klucza
Last check completed on %s=Ostatnie sprawdzenie ukończono **%s**
Last check incomplete on %s=Ostatnie przerwanie sprawdzenia **%s**
Last checked on %s=Ostatnie sprawdzenie **%s**
Last SMART test result=Ostatni wynik sprawdzenia SMART
Maintenance mode=Tryb Konserwacji
Maintenance Mode=Tryb konserwacji
Maintenance=Konserwacja
Manufacturing date=Data produkcji
Menu View=Widok menu
Minimum free space=Minimalna wolna przestrzeń
mirror=
Missing Cache disk=Brak dysku pamięci podręcznej
Missing disk=Brak dysku
Missing key=Brak klucza
Missing=Brak
Mounted=Zamontowany
Mover is running=Skrypt przenoszący dane jest uruchomiony
network settings=ustawienia sieciowe
New data disks detected=Wykryto nowe dyski na dane
next device=następne urządzenie
No array data disks have been assigned=Brak dysków danych ustawionych w macierzy
No data disks=Brak dysków danych
no devices=
No parity check history present=Brak historii sprawdzania danych parzystości
No self-tests logged on this disk=Brak autotestów w dziennikach dla tego dysku
Not installed=Niezainstalowano
Not present=
OK=OK
Once copy completes, the array may be Started, to initiate Data-Rebuild of the disabled disk=Gdy czyszczenie się zakończy, macierz może zostać uruchomiona, by rozpocząć odbudowę danych z niesprawnego dysku
operation=operacja
Options see Help=Opcje (zobacz pomoc)
Otherwise use the keyfile method for UTF8 input=W innym przypadku użyj metody **plik klucza** dla wprowadzenia znaków UTF8
Parity disks content will be overwritten=Zawartość *dysku parzystości* zostanie nadpisana
Parity is already valid=Dane parzystości są prawidłowe
Parity Operation History=Historia operacji na danych parzystości
Parity operation is running=Generowanie danych parzystości w toku
Parity valid requires ALL disks to have their original content=Sprawdzenie *parzystości* wymaga, aby **WSZYSTKIE** dyski miały oryginalną zawartość
Parity-Check in progress=Sprawdzanie danych parzystości w toku
ParityRead-Check History=Historia odczytu/sprawdzania danych parzystości
Parity-Sync in progress=Synchronizacja parzystości w toku
Parity-SyncData-Rebuild in progress=Synchronizacja parzystości/odtwarzanie danych w toku
Partition format=Format partycji
Partition size=Rozmiar partycji
Passed=Zaliczony
Passphrase=Hasło
Perform full balance=Wykonaj pełne balansowanie
Permit UEFI boot mode=Zezwól na uruchomienie w trybie UEFI
Please change share SMB security=Zmień zabezpieczenia udziałów SMB
Please check your system settings to support UEFI boot mode=Sprawdź ustawienia systemu, by wykorzystać uruchomienie w trybie UEFI
Please try again=
Pool Devices=Urządzenia w puli
Pool name already exists=Nazwa puli już istnieje
Pool of %s devices=Pula %s urządzeń
Pool Status=
Preclear in progress=Wstępne czyszczenie w toku
previous device=poprzednie urządzenie
Printable Characters Only=Wyłącznie drukowalne znaki
Proceed to start=Przejdź do początku
raid0=
raid1=
raid10=
raid1c3=
raid1c4=
raid5=
raid6=
raidz=
raidz2=
raidz3=
Raw Value=Surowa wartość
Raw View=Surowy widok
Read-Check in progress=Sprawdzanie poprzez odczyt w toku
Read errors corrected=
Read errors detected=
Reading=Odczytuję
Reboot in safe mode=Uruchom ponownie w trybie bezpiecznym
Registration Key Manager=Manager kluczy licencyjnych
registration key=klucz licencyjny
ReiserFS is deprecated, please use another file system=
reiserfsck status=status reiserfs
Rename Pool=Zmień nazwę puli
Repair corrupted blocks=Napraw uszkodzone bloki
Replacement disk installed=Dysk zastępczy zainstalowany
Replacement disk is too small=Dysk zastępczy jest zbyt mały
Retype passphrase=Ponownie wprowadź hasło
Schedule=Harmonogram
Scrub Status=Status oczyszczania
Scrub=Oczyszczanie
See %s Settings=Zobacz ustawienia %s
self-test in progress=Autotest w toku
Self-Test=Autotest
Server boot mode=Tryb uruchomienia serwera
Set default boot menu=Ustaw domyślne menu uruchomienia
show passphrase=pokaż hasło
Show=Pokaż
single=
Slots=Pozycje
SMART attribute notifications=Powiadomienie o atrybucie SMART
SMART controller type=Typ kontroloera SMART
SMART error log=Dziennik błędów SMART
SMART extended self-test=Rozszerzony autotest SMART
SMART health-check failed=Sprawdzenie zdrowia SMART zawiodło
SMART notification tolerance level=Poziom powiadomień SMART
SMART notification value=Powiadomienie o wartości SMART
SMART self-test history=Historia autotestów SMART
SMART self-test in progress=Trwa test SMART
SMART Settings=Ustawienia SMART
SMART short self-test=Krótki autotest SMART
SMART status=Status SMART
Speed=Prędkość
Spin down delay=Opóźnienie uśpienia dysku
Spin Down=Uśpienie dysku
Spin Up=Wybudzenie dysku
Spinup groups=Grupy wybudzania
Started, array protected=Uruchomiona, macierz chroniona
Started, array unprotected=Uruchomiona, macierz niechroniona
Started, clearing=Uruchomiona, czyszczenie w toku
Started, formatting=Uruchomiona, formatowanie w toku
Starting, copying=Uruchomiona, kopiowanie
Starting=Uruchamianie
Stopping=Zatrzymywanie
Sync errors corrected=Poprawione błędy synchronizacji
Sync errors detected=Wykryte błędy synchronizacji
Sync errors=Błędy synchronizacji
Sync=Synchronizacja
Syslinux Configuration=Konfiguracja syslinux
Syslinux configuration=konfiguracja syslinux
Temp=Temp
The array will be immediately available, but unprotected since parity has not been assigned=Macierz będzie dostępna natychmiast, lecz z powodu braku dysku parzystości, nie będzie chroniona
The array will be immediately available, but unprotected until Parity-Sync completes=Macierz będzie dostępna natychmiast, lecz będzie niechroniona do momentu zakończenia synchronizacji danych parzystości
The replacement disk must be as big or bigger than the original=Wymienny dysk musi mieć taką samą lub większą pojemność od dysku oryginalnego
This is typically done when a new disk is added to the array to get it ready for files to be written to it=To jest najczęściej wykonywane, gdy nowy dysk jest dodawany do macierzy bo przygotować ją na przyjęcie nowych danych
This Unraid OS release has been withdrawn and may no longer be used Please=Ta wersja systemu Unraid została wycofana i nie może być już używana.
This will ERASE ALL device content=Ta operacja USUNIE zawartość WSZYSTKICH urządzeń
This will ERASE content of ALL devices in the pool=Ta operacja USUNIE zawartość WSZYSTKICH urządzeń w puli
This will reboot the system=To uruchomi system ponownie
This will shutdown the system=To wyłączy system
This will stop the array=To zatrzyma macierz
This will stop the running operation=To zatrzyma aktualnie wykonywaną operację
Threshold=Próg
Title=Tytuł
To confirm your action type %s=Aby potwierdzić wykonanie wpisz: %s
Toggle readswrites display=Przełącz na widok odczytów/zapisów
Too many attached devices Please consider upgrading your=Zbyt wiele podłączonych urządzeń. Proszę rozważ aktualizację swojego
Too many wrong andor missing disks=Zbyt wiele błędnych i/lub brakujących dysków
Total size=Całkowity rozmiar
Unassign ALL devices to delete this pool=Cofnij przypisanie **WSZYSTKICH** urządzeń, by usunąć tę pulę
Unassigned Devices=Nieprzypisane urządzenia
Unavailable - disk must be spun up=Niedostępne - dysk musi wyjść ze stanu uśpienia
unavailable no parity-check entries logged=niedostępne (brak wpisów ze sprawdzania danych parzystości w dzienniku)
Unavailable=Niedostępne
Unclean shutdown detected=Wykryto nieprawidłowe zamknięcie
Unmountable disk present=Niemontowalny dysk obecny
Unmountable disks present=Niemontowalne dyski obecne
Unmountable Encrypted volume present=Niemontowalny: wolumin zaszyfrowany obecny
Unmountable Missing encryption key=Niemontowalny: brak klucza szyfrującego
Unmountable No file system=Niemontowalny: brak systemu plików
Unmountable No pool uuid=Niemontowalny: brak uuid puli
Unmountable not btrfs pool=Niemontowalny: to nie jest pula brtfs
Unmountable Unsupported or no file system=Unmountable: Unsupported or no file system
Unmountable Volume not encrypted=Niemontowalny: wolumin niezaszyfrowany
Unmounted=Odmontowany
Upgrading diskswapping parity=Wymiana dysku/zamiana dysku parzystości
Use ASCII characters from space to tilde=Użyj znaków **ASCII** od spacji do tyldy
Use Default=Użyj domyślnych
Use default=Użyj domyślnych
Use only lowercase with no special characters or leadingtrailing digits=Użyj wyłącznie małych liter, bez znaków specjalnych i cyfr umieszczonych na początku lub końcu
use printable characters only=użyj wyłącznie znaków drukowalnych
Used=Użyte
Value=Wartość
WARNING canceling may leave the array unprotected=OSTRZEŻENIE: anulowanie może pozostawić macierz niechronioną
Warning disk temperature threshold=Ostrzeżenie progu temperatury dysku
Warning disk utilization threshold=Ostrzeżenie progu użycia dysku
WARNING=OSTRZEŻENIE
Warranty period=Okres gwarancyjny
will activate a clean system power down=aktywuje prawidłowe zamknięcie systemu
will activate a clean system reset=aktywuje prawidłowy reset systemu
will bring the array on-line and start Clearing new data disks=uruchomi macierz i rozpocznie **czyszczenie** nowych dysków danych
will bring the array on-line and start Data-Rebuild=uruchomi macierz i rozpocznie **odbudowę danych**
will bring the array on-line and start Disk-Clear of new data disks=uruchomi macierz i rozpocznie **czyszczenie** nowych dysków danych
will bring the array on-line and start Parity-Check=uruchomi macierz i **sprawdzanie danych parzystości**
will bring the array on-line and start Parity-Sync andor Data-Rebuild=uruchomi macierz i **synchronizację danych parzystości** i/lub **odbudowę danych**
will bring the array on-line and start Parity-Sync=uruchomi macierz i rozpocznie *synchronizację danych parzystości**
will bring the array on-line=uruchomi macierz
will copy the parity information to the new parity disk=skopiuje dane parzystości na nowy dysk parzystości
will create a file system in all Unmountable disks=stworzy system plików na wszystkich Niemontowalnych dyskach
will delete the encryption keyfile=skasuje plik klucza używany do szyfrowania
will disable the missing disk and then bring the array on-line Install a replacement disk as soon as possible=wyłączy brakujący dysk i uruchomi macierz. Zainstaluj nowy dysk tak szybko jak to możliwe
will expand the file system of the data disk if possible then bring the array on-line and start Data-Rebuild=rozszerzy system plikówrzyma  na dysku danych, i jeśli to będzie możliwe, uruchomi macierz i uruchomi odbudowywanie danych
will immediately clear all disk statistics=natychmiast usunie wszystkie statystyki dysków
will immediately invoke the Mover=natychmiast uruchomi skrypt przenoszący dane
will immediately spin down all disks=natychmiast uśpi wszystkie dyski
will immediately spin up all disks=natychmiast wybudzi wszystkie dyski
will pause Data-Rebuild=wstrzyma odbudowę danych
will pause Disk-Clear=wstrzyma czyszczenie dysków
will pause Parity-Check=wstrzyma sprawdzanie danych parzystości
will pause Parity-Sync=wstrzyma synchronizację danych parzystości
will pause Read-Check=wstrzyma test odczytu danych
will pause the Clearing=wstrzyma Czyszczenie
will pause the Parity-Check=wstrzyma sprawdzanie danych parzystości
will pause the Parity-SyncData-Rebuild=wstrzyma synchronizację danych parzystości/odbudowywanie danych
will pause the Read-Check=wstrzyma sprawdzanie odczytu
will record all disk information and bring the array on-line=zapisze dane wszystkich dysków i uruchomi macierz
will record all disk information, bring the array on-line, and start Parity-Sync=apisze dane wszystkich dysków, uruchomi macierz i rozpocznie synchronizację danych parzystości
will remove the missing cache disk and then bring the array on-line=usunie brakujący dysk pamięci podręcznej i uruchomi macierz
will resume Data-Rebuild=wznowi odbudowę danych
will resume Disk-Clear=synchronizację czyszczenie dysków
will resume Parity-Check=wznowi sprawdzanie danych parzystości
will resume Parity-Sync=wznowi synchronizację danych parzystości
will resume Read-Check=wznowi test odczytu danych
will resume the paused Clearing=wznowi wstrzymane Czyszczenie
will resume the paused Parity-Check=wznowi wstrzymane sprawdzanie danych parzystości
will resume the paused Parity-SyncData-Rebuild=wznowi wstrzymaną synchronizację danych parzystości/odbudowywanie danych
will resume the paused Read-Check=wznowi wstrzymane sprawdzanie odczytu
will start Clearing new data disks=uruchomi **Czyszczenie** nowych dysków danych
will start Data-Rebuild=uruchomi **odbudowę danych**
will start Disk-Clear of new data disks=uruchomi **czyszczenie** nowych dysków danych
will start Parity-Check=uruchomi **sprawdzanie danych parzystości**
will start Parity-Sync andor Data-Rebuild=uruchomi **synchronizację danych parzystości** i/lub **odbudowywanie danych**
will start Parity-Sync=uruchomi **synchronizację danych parzystości**
will start Read-Check of all array disks=uruchomi **sprawdzanie odczytu** wszystkich dysków w macierzy
will stop Clearing=zatrzyma czyszczenie
will stop Data-Rebuild=zatrzyma odbudowę danych
will stop Disk-Clear=zatrzyma czyszczenie dysków
will stop Parity-Check=zatrzyma sprawdzanie danych parzystości
will stop Parity-Sync=zatrzyma synchronizację danych parzystości
will stop Parity-SyncData-Rebuild=zatrzyma synchronizację danych parzystości/odbudowywanie danych
will stop Read-Check=zatrzyma test odczytu danych
will stop the Parity-Check=zatrzyma sprawdzanie danych parzystości
will stop the Read-Check=zatrzyma sprawdzanie odczytu
will take the array off-line=zatrzyma macierz
Worst=Najgorszy
Write corrections to parity=Poprawki zapisu danych parzystości
Writes=Zapisy
Wrong key=Błędny klucz
Wrong Pool State=
xfs_repair status=Status naprawy xfs
You may not add new disks and also remove existing disks=Nie możesz dodać ani usunąć istniejącego dysku
your server=twój serwer
zfs pool status=
zfs=

; Sleep plugin translations
Check this=Sprawdź to
for more information=po więcej inforamcji
Make sure your server supports S3 sleep=Upewnij się że twój serwer obsługuje tryb S3 wstrzymywania uśpienia
Sleep will immediately put the server in sleep mode=**Uśpij** spowoduje natychmiastowe przeście serwera w tryb uśpienia
Sleeping=Śpiący
System in sleep mode=System w trybie uśpienia
This will put the system in sleep mode=To spowoduje uśpienie systemu
wiki entry=wpis wikipedii

; Note: April 11, 2023 - 28 missing translations
