%s An update is available=%s: dostępna jest aktualizacja
Alert Message=Komunikat alarmowy
anonymous=anonimowy
Author=Autor
Check For Updates=Sprawdź dostępnośc aktualizacji
Checking connectivity=Sprawdzanie połączenia
checking=sprawdzanie
Click here to install version %s=Kliknij tutaj by zainstalować wersję %s
Delete Plugin=Skasuj wtyczkę
DOWNGRADE TO VERSION=PRZYWRÓC WERSJĘ
Enter URL of remote plugin file or local plugin file=Wpisz adres URL zdalnej lokalizacji pliku z wtyczką lub ścieżkę do lokalnego pliku
ERROR=BŁĄD
I have read the release notes=Przeczytałem informacje o wydaniu
Install Plugin=Zainstaluj wtyczkę
Install=Instaluj
install=instaluj
Installed Plugins=Zainstalowane wtyczki
Installing Update=Instaluję aktualizację
need check=wymagane sprawdzenie
Next=Następny
No plugins installed=Żadna wtyczka nie została zainstalowana
No release notes available=Brak informacji o wydaniu
No response, aborting=Brak odpowiedzi, przerywanie
Plugin File Install Errors=Błąd instalacji wtyczki
Plugin File=Plik wtyczki
Plugin History=Historia wtyczki
Plugin Update Check=Sprawdzenie aktualizacji wtyczki
Plugin=Wtyczka
Release Notes=Informacje o wydaniu
Remove Plugin=Usuń wtyczkę
Remove Selected Plugins=Usuń wybrane wtyczki
remove=usuń
Select local plugin file=Wybierz lokalny plik wtyczki
Stable=Stabilna
STALE=PRZESTARZAŁA
Support Thread=Wątek wsparcia
Uninstall=Odinstaluj
Update All Plugins=Odśwież wszystkie wtyczki
Update Incompatible=Aktualizacja niekompatybilna
Update Plugin=Zaktualizuj wtyczkę
Upgrade=Aktualizuj
View Release Notes=Zobacz informacje o wydaniu
