Cancel=Anuluj

; My PSAs / banners
Happy New Year=Szczęśliwego Nowego Roku
Happy Holidays from Andrew, Tracey, and family=Wesołych Świąt życzy Andrew, Tracey oraz rodzina
Please Enjoy Responsibly=Proszę używaj odpowiedzialnie
Popup Blocked CA requires popups to be enabled under certain circumstances You must white list your server within your browser to allow popups=Zablokowany Popup, CA wymaga odblokowania popapów w specyficznych okolicznościach, musisz dodać swój serwer do białej listy w przeglądarce aby zezwolić na wyskakujące okna.
Docker Service Not Enabled - Only Plugins Available To Be Installed Or Managed=Usługa Docker nieaktywna - Możliwość instalacji i zarządzania tylko wtyczkami
Docker system failed to start - Only Plugins Available To Be Installed Or Managed=Nie udało się uruchomić Dockera - Możliwość instalacji i zarządzania tylko wtyczkami
Array not started - Only Plugins Available To Be Installed Or Managed=Macierz nie uruchomiona - Możliwość instalacji i zarządzania tylko wtyczkami
Community Applications works best when cookies are enabled in your browser Certain features may not be available=Aplikacje społeczności działają najlepiej gdy ciasteczka są dozwolone w Twojej przeglądarce, niektóre funkcjonalności mogą być niedostępne
Backup Server Active Some icons may not appear, and plugin installations may be affected=Zapasowy Serwer Aktywny Część ikon może nie być widoczna, może mieć wpływ na instalację wtyczek
Debugging enabled This significantly increases the memory used by your browser=Aktywowano debugowanie, może to znacząco zwiększyć zużycie pamięci przez Twoją przeglądarkę
Browser translation detected Display issues may result=Wykryto tłumaczenie przeglądarki, może skutkować problemami z wyświetlaniem.
Action Centre Enabled=Centrum akcji włączone

; Sorting Options
Sort By=Sortuj po
Name Ascending=Nazwa rosnąco
Name Descending=Nazwa malejąco
Downloads=Ilość pobrań
Date Added=Data dodania
Number Of Apps=Ilość aplikacji
; Initial disclaimer translations
Disclaimer=Odpowiedzialność
All applications listed here are 3rd party additions to Unraid Neither the authors of Community Applications nor Limetech make any warranty as to the suitability of any application listed here=Wszystkie aplikacje są zewnętrznymi dodatkami, ani autorzy aplikacji ani Limetech nie udziela gwarancji zgodności żadnej aplikacji na liście
Every attempt is made to ensure that only safe and compatible applications are present=Dokładamy wszelkich starań aby zweryfikować czy udostępniane aplikacje są kompatybilne
Application Policy=Polityka aplikacji
I Understand=Rozumiem
Installations of apps disabled You must accept the warning to be able to install applications=Instalacja aplikacji jest zablokowana do czasu zaakceptowania ostrzeżenia.
Click here=Kliknij tutaj
%s Results Per Page=%s wyników na stronie
Results Per Page: %s=Wyników na stronie: %s

; Plugin Disclaimer
Community Applications contains both docker containers and plugin applications Plugins are designed for OS enhancements, and run with full privileges on your system and are clearly identified within CA=Aplikacje społeczności zawierające kontenery dockera i wtyczki aplikacji są zaprojektowane do rozszerzenia funkcjonalności systemu i uruchamiane z pełnymi uprawnieniami systemu oraz wyraźnie identyfikowane w ramach CA
Plugin Note=Uwagi dotyczące wtyczki

; Multi Install
Install Plugin Applications=Instalacja Aplikacji
Select all on page=Zaznacz wszystkie na stronie
Install Application=Zainstaluj Aplikację
Install Applications=Zainstaluj Aplikacje
Update Applications=Zaktualizuj Aplikacje
Are you sure you want to update %s applications=Czy jesteś pewien, że chcesz zaktualizować aplikacje: %s
Are you sure you want to install %s docker and %s plugin applications=Czy jesteś pewien, że chcesz zainstalować docker(y) %1$s oraz wtyczk(i) %2$s

; Searches
Search=Szukaj
Click Here To Get More Results From DockerHub=Aby uzyskać więcej wyników z DockerHub kliknij tutaj
No Matching Applications Found=Nie znaleziono pasujących aplikacji

; Repository Related
%s removed as favourite repository=Usuń %s z ulubionych repozytoriów
%s set as favourite repository=Ustaw %s jako ulubione repozytorium
Click to remove favourite repository=Kliknij aby usunąć ulubione repozytorium
Click to set %s as favourite repository=Kliknij aby ustawić %s jako ulubione repozytorium
Search for apps in repository=Szukaj aplikacji w repozytorium
No description present=Brak opisu
Go to the forum page=Idź na forum
Go to the webpage=Idź na stronę
Go to reddit=Idź na reddit
Go to facebook=Idź na facebooka
Go to discord=Idź na discorda
Go to forum profile=Zobacz profil na forum
Show Profile=Pokaż profil
SHOW MORE=POKAŻ WIĘCEJ
SHOW LESS=POKAŻ MNIEJ
Read more=Czytaj dalej
Total Applications=Wszystkie Aplikacje
Total Known Downloads=Wszystkie znane pobrania
Total Docker Applications=Wszystkie Dockery
Total Plugin Applications=Wszystkie Wtyczki
Total Languages=Wczystkie Pakiety Językowe
Average Downloads Per App=Średnia liczba pobrań na Aplikację
Web Page=Strona internetowa
Forum=Forum
Forum Profile=Profil na forum
Profile=Profil
Facebook=Facebook
Reddit=Reddit
Twitter=Twitter
Discord=Discord
Search Apps=Wyszukaj aplikacje
Registry=Rejestr
Details=Szczegóły
Added=Dodano
; Install Plugin title of openbox
Install Plugin=Zainstaluj wtyczkę
Update Plugin=Aktualizuj wtyczkę

Requirements not met=Niespełnione wymagania
The requirements for this upgrade have not been met on your system=Wymagania dla tej aktualizacji nie zostały spełnione w Twoim systemie.
The sidebar for the app click info will list the details=Pasek boczny aplikacji wyświetli szczegóły po kliknięciu

BACK=WSTECZ

; Remove App from previously installed
Delete Template=Usuń szablon
Yes, delete it=Tak, usuń

; Uninstall popup
Uninstall Application=Odinstaluj Aplikację
Yes uninstall it=Tak, odinstaluj

; Remove Private Application
Remove Private Application=Usuń Prywatną Aplikację
Yes, remove it=Tak, usuń

; App Pinning
Click to pin this application=Kliknij aby przypiąć tą aplikację
Click to unpin this application=Kiknij aby odpiąć tą aplikację
Pin App=Przypnij aplikację
Unpin App=Odepnij aplikację

; Branch installations
Choose A Branch To Install=Wybierz gałąź do instalacji

; Multiple application installs
; no apps selected
Install Selected Applications=Zainstaluj Zaznaczone Aplikacje

Yes, install it=Tak, Zainstaluj

; Multi-install popup
Yes, install them=Tak, Zainstaluj je
Cookies not enabled Plugins must be separately installed from docker applications=Zablokowane ciasteczka, Wtyczki muszą być instalowane oddzielnie od aplikacji docker
Docker applications will be installed utilizing the most recently saved template with no user input on your part=Aplikacja Docker zostanie zainstalowana używając ostatnio zapisanego szablonu bez udziału użytkownika
Updating Support Links=Aktualizacja odnośników wsparcia
Downloading docker icons=Pobieranie ikon dockera
Finished Installing If the DONE button did not appear, then you will need to click the red X in the top right corner=Instalacja zakończona, jeśli przycisk Zrobione nie pojawił się kliknij czerwony X w górnym prawym rogu

; error messages
No data was returned It is probable that another browser session has rebooted your server Reloading this browser tab will probably fix this error=Żadne dane nie zostały odebrane, prawdopodobnie w innej sesji przeglądarki serwer został zrestartowany, odświeżenie tej przeglądarki powinno rozwiązać ten problem
An error occurred Could not find any %s Apps=Wystąpił błąd, nie można znaleźć żadnych %s aplikacji
Download of appfeed failed=Błąd aktualizacja kanału aplikacji
; the %s here refers to a function being called
Something really went wrong here=Naprawdę coś poszło nie tak
Post the ENTIRE contents of this message in the Community Applications Support Thread=Opublikuj treść tego komunikatu w wątku wsparcia na forum
Unknown error happened Please post a screenshot in the support thread of the Statistics screen=Nieznany błąd Zgłoś w wątku wsparcia Załącz zrzut ekranu z Widoku Statystyk
Something really wrong happened Reloading the Apps tab will probably fix the problem=Coś naprawdę poszło nie tak odświeżenie zakładki aplikacji powinno rozwiązać problem
This plugin has a duplicated name from another plugin %s This will impact your ability to install both plugins simultaneously=Ta wtyczka ma zdublowaną nazwę z inną już zainstalowaną wtyczką %s co ma wpływ na możliwość instalacji obydwu wtyczek jednocześnie
You have been logged out=Zostałeś wylogowany
Fatal Flash Drive Error=Fatalny błąd dysku Flash
This usually means your flash drive is corrupted or has dropped offline The rest of the Unraid GUI will also be affected Post a new thread in the Unraid forums if this error continues=To przeważnie oznacza, że Twój dysk Flash jest uszkodzony lub offline. Może mieć to wpływ na całe GUI Unraid. Załóż nowy wątek na forum Unraid jeśli błąd będzie nadal występował.
Fatal Docker Image Error=Fatalny błąd obrazu Dockera
Your docker image or folder is either read-only or completely full Issues will result because of this You should create a new post in the Unraid forums and include your diagnostics=Twój obraz docker lub folder jest albo tylko do odczytu albo zapełniony. Zgłoś problem na forum Unraid załączając Dane Diagnostyczne.
This template is set up to use a custom network You may have to adjust the network or IP address etc to match your system=Ten szablon jest skonfigurowany do używania niestandardowej sieci. Być może powinieneś skonfigurować sieć lub ustawić adres IP lub inne.
One or more ports used by this application are already in use by another service or app running on your server You will need to adjust the host ports accordingly on the template=Conajmniej jeden port używany przez tą aplikację jest używany przez inny serwis lub uruchomioną aplikację. Powinieneś dostosować ustawienie portów hosta dla tego szablonu.

; CA Sections Keep the length reasonable
Home=Strona główna
Installed Apps=Zainstalowane
Previous Apps=Wcześniej używane
Pinned Apps=Przypięte
Favourite Repo=Ulubione repozytorium
Action Centre=Centrum akcji
Recently Added=Ostatnio dodane
Random Apps=Losowe
Top New Installs=Top nowych instalacji
Top Trending Apps=Zyskujące popularność
Spotlight Apps=Wyróżnione
All Apps=Wszystkie
Statistics=Statystyki
Credits=Autorzy
Support=Wsparcie
VERSION=WERSJA
Change Log=Dziennik zmian
Debugging=Debugowanie

; Credits
Development=Autor/Rozwój
Additional Contributions=Współautorzy
GUI Layout Design=Projekt GUI
Application Feed=Kanał aplikacji
Additional Testing=Dodatkowe testy
Moderation=Moderacja
Additional Libraries=Dodatkowe biblioteki
Copyright=Prawa autorskie
Translation=Tłumaczenie

; Statistics page

unknown=nieznany
Last Change To Application Feed=Ostatnia zmiana na Kanale Aplikacji
Docker Applications=Aplikacje Docker
Plugin Applications=Wtyczki aplikacji
Templates=Szablony
Official Containers=Oficjalne kontenery
Repositories=Repozytoria
Private Docker Applications=Prywatne aplikacje Docker
Invalid Templates=Szablony nieprawidłowe
Template Errors=Błędy Szablonu
Blacklisted Apps=Czarna lista aplikacji
Incompatible Applications=Niekompatybilne
Deprecated Applications=Przestarzałe
Moderation Entries=Wpisy moderacyjne
Primary Server=Podstawowy serwer
Backup Server=Serwer zapasowy
Installs not allowed from this page=Instalacje niedozwolone z tej witryny

; Statistics Popup
No invalid templates found=Nie znaleziono nieważnych szablonów
These templates are invalid and the application they are referring to is unknown=Te szablony są nieważne i aplikacje odwołujące się do nich są nieznane
No templates were automatically fixed=Żaden szablon nie został automatycznie naprawiony
All of these errors found have been fixed automatically=Wszystkie znalezione błędy zostały automatycznie naprawione
Note that many of these errors can be avoided by following the directions=Wszystkie tych błędów można uniknąć stosując wskazówki
HERE=TUTAJ
The following plugins have duplicated filenames and are not able to be installed simultaneously=Te wtyczki mają zduplikowane nazwy plików i nie mogą być zainstalowane jednocześnie
The following docker applications refer to the same docker repository but may have subtle changes in the template to warrant this=Te aplikacje docker odnoszą się do tego samego repozytorium ale mogą mieć subtelne zmiany w szablonie aby to zagwarantować
If any of these entries are incorrect then contact the moderators of CA to discuss=Jeżeli któryś z wpisów jest niepoprawny skontaktuj się z moderatorami Aplikacji Społeczności aby omówić problem
Global Repository Comments=Komentarz do globalnego repozytorium
Applied to all applications=Zastosowane do wszystkich aplikacji
Individual Application Moderation=Indywidualna Moderacja Aplikacji

; Misc
Community Applications Changelog=Aplikacje Społeczności Dziennik Zmian

Each month we highlight some of the amazing work from our community=Każdego miesiąca wyróżniamy niesamowitą pracę spośród naszej społeczności
Check out these newly added applications from our awesome community=Sprawdź te ostatnio dodane aplikacje od naszej niesamowitej społeczności
Check out these up and coming apps=Sprawdź te nadchodzące aplikacje
These apps have the highest percentage of new installs=Te aplikacje mają najwyższy procentowy współczynik nowych instalacji
An assortment of randomly chosen apps=Zbiór losowo wybranych aplikacji

; Categories try not to be excessively long This is displayed on the left of CA screen

Backup=Kopia zapasowa
Cloud=Chmura
Crypto Currency=Kryptowaluty
Downloaders=Pobieranie
Drivers=Sterowniki
Game Servers=Serwery gier
Home Automation=Automatyzacja domu
Media Applications=Multimedia
Books=Książki
Music=Muzyka
Photos=Obrazy
Video=Wideo
Other=Inne
Media Servers=Serwery mediów
Network Services=Usługi sieciowe
DNS=DNS
FTP=FTP
Management=Zarządzanie
Messenger=Komunikacja
Proxy=Proxy
VOIP=VOIP
VPN=VPN
Web=Web
Privacy=Prywatność
Productivity=Produktywność
Security=Bezpieczeństwo
Spotlight=Wyróżnione
Tools Utilities=Przybory / Narzędzia
System=System
Themes=Motywy
Utilities=Narzędzia
Private Apps=Prywatne Aplikacje
Uncategorized=Bez kategorii

; Categories displayed within a popup or on the card.  Where an entry exists after the "=" it is not translated, but rather how it should look
GameServers=SerweryGier
HomeAutomation=AutomatyzacjaDomu
MediaApp=Media
MediaAppBooks=Media:Książki
MediaAppMusic=Media:Muzyka
MediaAppPhotos=Media:Obrazy
MediaAppVideo=Media:Wideo
MediaAppOther=Media:Inne
MediaServer=MediaSerwer
MediaServerBooks=MediaSerwer:Książki
MediaServerMusic=MediaSerwer:Muzyka
MediaServerPhotos=MediaSerwer:Obrazy
MediaServerVideo=MediaSerwer:Wideo
MediaServerOther=MediaSerwer:Inne
Network=Sieć
NetworkDNS=Sieć:DNS
NetworkFTP=Sieć:FTP
NetworkManagement=Sieć:Zarządzanie
NetworkProxy=Sieć:Proxy
NetworkVOIP=Sieć:VOIP
NetworkVPN=Sieć:VPN
NetworkPrivacy=Network:Privacy
NetworkWeb=Sieć:Web
NetworkOther=Sieć:Inne
ToolsSystem=Narzędzia:System
ToolsThemes=Narzędzia:Motywy
ToolsUtilities=Narzędzia:Przybory
OtherUncategorized=Inne:Bezkategorii
and %s more=i %s więcej

; App Popup Related
This application template has been blacklisted=Ten szablon aplikacji został dodany do czarnej listy
This application template has been deprecated=Ten szablon aplikacji został wycofany
This application has additional requirements=Ta aplikacja ma dodatkowe wymagania
Additional Requirements=Dodatkowe wymagania
Donate To Author=Wesprzyj autorów
Donate To Maintainer=Wesprzyj opiekunów
CLOSE=ZAMKNIJ
Author=Autor
Maintainer=Opiekun
DockerHub=DockerHub
Application Template=Szablon aplikacji
DockerHub Stars=Gwiazdki DockerHub
Added to CA=Dodano do CA
Date Updated=Data aktualizacji
Current Version=Aktualna wersja
Min OS=Minimalna wersja OS
Max OS=Maksymalna wersja OS
Total Downloads=Całkowita ilość pobrań
Licence=Licencja
Ranked #%s=W rankingu #%s
; as in Trending up or down arrow
Trending %s=Trend %s
; as in As of some date
As of %s=(As of %s)
Play Video=Odtwórz Wideo
Play Video %s=Odtwarzaj Wideo %s
This application is not compatible with your version of Unraid=Ta aplikacja jest niekompatybilna z Twoją wersją Unraid
Another browser tab or device has updated the displayed templates Some actions are not available=Wyświetlany szablon został zaktualizowanej za pomocą innej zakładki przeglądarki lub innego urządzenia. Część operacji jest niedostępna
WebUI=Interfejs Web
Reinstall=Reinstalacja
Reinstall From Previous Apps=Reinstaluj z wcześniejszej aplikacji
Install=Instalacja
Uninstall=Deinstalacja
Project=Projekt
Read Me First=Przeczytaj Najpierw
Install Using The Templates Default Tag=Zainstaluj używając Domyślnych Tagów Szablonu
Moderator Comments=Komentarz moderatora
Note not all authors keep up to date on change logs=Nie wszyscy autorzy śledzą na bieżąco dziennik zmian
Note not all maintainers keep up to date on change logs=Nie wszyscy opiekunowie są na bieżąco z dziennikiem zmian
Last Update=Ostatnia aktualizacja
Note All statistics are only gathered every 30 days=Info: Wszystkie statystyki są zbierane co 30 dni
;the following if using a space you MUST use nbsp but keep it down to one word if at all possible
Donate=Wesprzyj
Currently Installed Version=Aktualnie zainstalowana wersja
Install The Update=Zainstaluj aktualizację
; as in you have the latest version already installed
Latest Version=Najnowsza wersja
Multi Language Support=Wsparcie wielu języków
Support Forum=Forum wsparcia
; as in more than 100000
More than %s=Więcej niż %s
Remove from Previous Apps=Usuń z wcześniejszych aplikacji
Remove=Usuń
See All Apps=Pokaż wszystkie Aplikacje
Favourite=Ulubione
Application Type=Typ aplikacji

; Graphs
Trend Per Month=Trend miesięczny
Downloads Per Month=Pobrań w miesiącu

; Multi install script
Installing docker applications %s=Instalacja dockerowej aplikacji %s
Starting %s=Uruchamianie %s
%s failed to start You should install it by itself to fix the errors=Podczas uruchamiania %s wystąpił błąd Zainstaluj samodzielnie aby rozwiązać ten problem
Setting installed applications to autostart=Ustawienie zainstalowanych aplikacji na autouruchamianie
Docker Application Installation finished=Instalacja aplikacji docker zakończona

; Application Cards
Actions=Akcje
Pending=Oczekujące
This application is a driver plugin=Ta aplikacja jest dodatkowym sterownikiem
This is a language pack=To jest pakiet językowy
This application is a docker container=Ta aplikacja jest kontenerem docker
This application is a plugin=Ta aplikacja jest wtyczką
This is a spotlight application=To jest wyróżniona aplikacja
This is your favourite repository=To jest Twoje ulubione repozytorium
This application is from your favourite repository=Ta aplikacja pochodzi z Twojego ulubionego repozytorium
This application is pinned for later viewing=Ta aplikacja jest przypięta do obejrzenia później
Private Application=Aplikacja prywatna
Remove Application From List=Usuń Aplikację z Listy
Check off to select multiple reinstalls=Zaznacz aby wykonać reinstalację wielu
Go to the plugin settings=Idź do ustawień wtyczki
Click to reinstall the application using default values=Kliknij aby reinstalować aplikację z użyciem wartości domyślnych
Click to edit the application values=Kliknij aby edytować parametry aplikacji
Click to reinstall=Kliknij aby przeinstalować
Click to install=Kliknij aby zainstalować
Click to go to the WebUI=Klikni aby przejść do interfejsu WEB
This application template has been deprecated=Ten szablon aplikacji został wycofany
This application template has been blacklisted=Ten szablon aplikacji został dodany do czarnej listy
Click info to see the notes regarding this application=Kliknij info aby zobaczyć informacje o tej aplikacji
This application has additional requirements=Ta aplikacja ma dodatkowe wymagania
BETA=BETA
INSTALLED=ZAINSTALOWANE
OFFICIAL=OFICJALNY
UPDATED=ZAKTUALIZOWANY
This is an official container=To jest oficjalny obraz
Digitally Signed=Podpisany cyfrowo
This container is digitally signed=Ten kontener jest podpisany cyfrowo
Docker Hub=Hub Dockera
NOTE You must visit the dockerHub page to gather the information required to install correctly=WAŻNE Aby poprawnie zainstalować musisz na stronie dockerHub sprawdzić jakie są wymagania.
Show CA templates=Pokaż szablony CA
Deprecated=Przestarzałe
Incompatible=Niekompatybilny
Blacklisted=Na czarnej liście
Template Exists=Szablon istnieje
Template already exists in Apps=Szablon już istnieje w Aplikacjach
; eg: LinuxServer Repository
%s Repository=Repozytorium %s
; eg: Squid's Repository
%s's Repository=Repozytorium %s

Info=Informacja
Attention=Uwaga
Repository=Repozytorium
Why we picked it=Dlaczego to wybraliśmy
Application Spotlight %s=Wyróżnione aplikacje
Unraid Staff=Personel Unraid

; Page Navigation
Displaying %s - %s of %s=Wyświetlanie %1$s - %2$s (z %3$s)

Updating Content=Aktualizacja zawartości
Language=Język
Switch to this language=Przełącz język
Country Code=Kod Kraju
Install Language Pack=Zainstaluj pakiet językowy
Remove Language Pack=Odinstaluj pakiet językowy
Update Language Pack=Aktualizuj pakiet językowy
Installed Version=Zainstalowana Wersja
A note about translations=Uwagi na temat tłumaczenia
Click here to view the language changelog=Kliknij tutaj aby zobaczyć dziennik zmian tłumaczenia
View Missing Translations=Zobacz brakujące tłumaczenia

; Update Checks
Check For Updates=Sprawdź dostępność aktualizacji
Check for updates already running=Sprawdź dostępność aktualizacje tylko dla uruchomionych
Checking for docker container updates=Sprawdź dostępność aktualizacji kontenerów docker
Checking for plugin updates=Sprawdź dostępność aktualizacji wtyczek
Checking for language updates=Sprawdź dostępność aktualizacji języków
Checking %s=Spwadzanie %s

; dockerHub conversions
Determine configuration=Ustalona konfiguracja
Would you like CA to attempt to determine any applicable paths, ports, and variables for the template This will entail performing a test installation of the container It will be automatically deleted after processing The container will not be started=Would you like CA to attempt to determine any applicable paths, ports, and variables for the template?  This will entail performing a test installation of the container.  It will be automatically deleted after processing.  Kontener nie zostanie uruchomiony.
An error occurred - Could not determine configuration=Wystąpił błąd - Nie można ustawić konfiguracji.
; WebGui
Click Install to download and install the Community Applications plugin=Kliknij **Instaluj** aby pobrać i zainstalować wtyczkę **Community Applications**


; Note: December 8, 2024 - 20 missing translations
Deprecated OS version No further updates to Community Applications will be issued for this OS version=
Update Application=
This template is set up to run as Privileged This is a possible security risk and usually does not need to be enabled Note that some applications require privileged in order to operate correctly=
Not Enough Memory=
Community Applications and Unraid OS have a minimum required installed memory of 4G CA cannot run without those mimimums being met=
Run Anyways=
Memory Requirements not met Problems may result=
Installation already in progress=
Another plugin installation or update is already in progress and this one cannot start Wait until the current installation or update is completed and try again=
Clear Flag=
%s is incompatible with your OS version Please update the OS to proceed=
%s is incompatible with your OS version Either uninstall %s or update the OS=
Browser failed to communicate with Unraid Server=
For unknown reasons, your browser was unable to communicate with Community Applications running on your server=
Attempt to Fix Via Reload Page=
External Link=
Clicking OK will take you to a 3rd party website not associated with Limetech=
Featured Applications=
Popularity=
Install another instance=
